1 templates
P0
WWWWWWWWWWWWWWWW
WSSSSSLSSSSSSSSW
WSSSSSLSSSLSSSSW
WLLLSSSSSSLSSLLW
WSSLSSLLLSLLSLSW
WSSLSSSSSSSSLLSW
WSSLSSLLLLSSSSSW
WSSSSSLSSLSSLLLW
WSSSSSLSSSSSSSSW
WWWWWWWWWWWWWWWW